10R00000000SSSSSS0000S002
00S0TT0S0S0S0000S0SS0S0SS
0R000S0S0S0S0SS0S0S00S0S0
00STTT00000S0S0000S0SS0S0
00000RRRR0SS0S0SS0S0S00S0
SSSS000000000S0SS0S0S0000
00000BBB0SSSSS0SSS00SSSSS
000SS00000000000S00000000
000000000SSSSSS000SSSSSSS
SSSSSSSS00000000SSSSS000S
000S00S00SSS0SS0S00000SSS
0S0S00S0SSSS0SS0S0SSS0SSS
0S0000S0S0000SS000SS000SS
0SSSS000S0SSS000SSS00000S
3000000000000000000000004