10C00000000MMMMMM0000M002
00C0MM0M0M0M0000M0MM0M0MM
0C000M0M0M0M0MM0M0M00M0M0
0MMM0M00000M0M0000M0MM0M0
00000MMMM0MM0M0MM0M0M00M0
MMMM000000000M0MM0M0M0000
00000CCC0MMMMM0MMM00MMMMM
000MM00000000000M00000000
000000000MMMMMM000MMMMMMM
MMMMMMMM00000000MMMMM000M
000M00M00MMM0MM0M00000MMM
0M0M00M0MMMM0MM0M0MMM0MMM
0M0000M0M0000MM000MM000MM
0MMMM000M0MMM000MMM00000M
3000000000000000000000004
