..O..O...O....O..O..O..
.MOMOMOMOMOMOMOMOMOMOM.
OO.OO...OOO...OOOOOOOOO
OMOM.M.M.MOM.M.M.M.M.MO
OOOO..OO..OOO.OOOO.OOOO
.M.MOM.MOM.MOM.MOM.M.MO
OOOOO.OOOO.OOOO.OOOOOOO
.M.M.MOM.M.MOM.MOM.M.MO
OOO..OOO.OOOOO.OOOOOOO.
OM.M.MOMOM.M.MOM.M.M.MO
OO.OO.OOOOOO.O.O..O.OOO
OM.M.M.M.MOMOM.M.M.M.M.
OOO.O..OOOO.OO.OO..O.OO
.MOMOM.M.M.M.MOM.M.M.M.
..O..OO...OO.OO.OO..O..