..........OOO..........
.MMMMMMMMMM.MMMMMMMMMM.
.M...................M.
OM.MMMMMMMMMMMMMMMMM.MO
OM.M...............M.MO
OM.M.MMMMMM.MMMMMM.M.MO
OM.M.M...........M.M.MO
OM...M.MMMMMMMMM.M...MO
OM.M.M...........M.M.MO
OM.M.MMMMMM.MMMMMM.M.MO
OM.M...............M.MO
OM.MMMMMMMMMMMMMMMMM.MO
.M...................M.
.MMMMMMMMMM.MMMMMMMMMM.
..........OOO..........