......O.O.....O.O......
.MOOOM.O.MOOOM.O.MOOOM.
.O...O...O...O...O...O.
.O...O...O...O...O...O.
.O...O...O...O...O...O.
.MOOOM...MOOOM...MOOOM.
O.....O.O.....O.O.....O
.O.....O.......O.....O.
O.....O.O.....O.O.....O
.MOOOM...MOOOM...MOOOM.
.O...O...O...O...O...O.
.O...O...O...O...O...O.
.O...O...O...O...O...O.
.MOOOM.O.MOOOM.O.MOOOM.
......O.O.....O.O......