..OOOOOOO.MMM.OOOOOOO..
.OOOOOOOO.MMM.OOOOOOOO.
OOOOOOOOO.MMM.OOOOOOOOO
OOOOOOOOO.MMM.OOOOOOOOO
OOOOOOOOO.MMM.OOOOOOOOO
...........M...........
MMMMMMMMM.....MMMMMMMMM
MMMMMMMMMM...MMMMMMMMMM
MMMMMMMMM.....MMMMMMMMM
...........M...........
OOOOOOOOO.MMM.OOOOOOOOO
OOOOOOOOO.MMM.OOOOOOOOO
OOOOOOOOO.MMM.OOOOOOOOO
.OOOOOOOO.MMM.OOOOOOOO.
..OOOOOOO.MMM.OOOOOOO..